
#######################################
#                 ###                 #
#   ###   #####   ###   #####   ###   #
#                                     #
#   ###   #   ###########   #   ###   #
#         #       ###       #         #
#######   #####   ###   #####   #######
#######   #                 #   #######
#######   #   ### - - ###   #   #######
#######   #   #         #   #   #######
|             #         #             |
#######   #   #         #   #   #######
#######   #   ###########   #   #######
#######   #                 #   #######
#######   #   ###########   #   #######
#                 ###                 #
#   ###   #####   ###   #####   ###   #
#     #                         #     #
###   #   #   ###########   #   #   ###
#         #       ###       #         #
#   ###########   ###   ###########   #
#                                     #
#######################################
