############################
#. . . . .  . # . . . . . .#
# ##.### ####. .### ####.#.#
#. . . . . . . . . . . . . #
# ##.#.#.###. #.###.#.# ##.#
#.##.#.#. . . . . .  .#.## #
#.  . .#.### - - ###.. .  .#
######.#.#         # #.#####
 . . . . #         #. .  .
######.#.###########.#.#####
#. . . . . . .# . . . .. . #
#.##.##### .  . ##### .###.#
#. #. . . . . . . . .  . . #
# .###.########### .  .###.#
#. . . . . ###. . . # . . .#
#.########.###. ##########.#
#. . . . . .  . . . . . . .#
############################
